cumprimentos tom fulp---lmao
Ludum dare -- extraordinário
cyberzone -- em breve
eu amo thriftman---swag
jogo de ritmo final -- provavelmente
jogo dope ass -- revista de playstation
em memória amorosa de -- henryeyes
dançando -- para sempre
funkin --- para sempre
ritz dx --- descanse em paz lol
classifique cinco -- por favor, não culpe
jogos de ritmo ---ultimate
jogo do ano -- para sempre
você sabe -- estamos realmente aqui
levante--se e moa--se -- amor para luis
como parappa -- mas mais legal
álbum do ano ---chuckie finster
gitaroo man free ---com amor para wandaboy
melhor que geometria traço -- lute comigo robtop
kiddbrute para presidente -- vote agora
jogar propriedade morta --- em novos terrenos
este é um maldito protótipo -- estamos trabalhando nele, ok?
as mulheres são reais -- isso é oficial
Demasiado superexpostos: os novos terrenos não nos aguentam.
Hatsune Miku: a maior inspiração
muitas pessoas -- minha cabeça dói
novos motivos --- para sempre
gosto refinado na música -- se é que posso dizer
o nome dele não é keith---dumb eggy lol
o nome dele não é evan ---estúpido tiktok
transmitir chuckie finster -- no spotify
nunca se esqueça -- reze a deus
não jogue ferrugem -- apenas funkin
adeus -- meu pênis
dababy ---maior inspiração
elegantemente atrasado -- mas aqui está
yoooooooooooo -- yoooooooo
bico engraçado -- bico engraçado
atualizações todas as sextas--feiras, sempre a tempo
aplausos para pedreiro -- para da manos
bonk --- entrar em chamada de discórdia